L L L L L L L L L L L L L L L L L L L L
L L L L L L L W W W W L L L L L L L L L
G G G G G G G W W W W L L L L L L L L L
G G G G G G G W W W W L L L L L L L L L
G G G G G G G W W W W L L L L L L L L L
L L L L L L L L L L L L L L L L L L L L
L L L L L L L L L L L L L L L L L L L L
L L L L L L L L L L L L L G G G G G G G
L L L L L L L L L L L L L G G G G G G G
L L L L L L L L L L L L L G G G G G G G
L L L L L L L L L L L L L G G G G G G G
L L L L L L L L L L L L L G G G G G G G
