L L L L L G G G G G G G G L L L L L L L
L L L L L G G W W W W G G L L L L L L L
L L L L L G G W W W W G G L L L L L L L
L L L L L G G W W W W G G L L L L L L L
P P P P P P P P P P P P P P P P P P P P
P P P P P P P P P P P P P P P P P P P P
P P P P P P P P P P P P P P P P P P P P
L L L L L L L L L L L L L G G G G G G G
D D D D D D L L L L L L L G G G G G G G
D D D D D D L L L L L L L G G G G G G G
D D D D D D L L L L L L L G G G G G G G
D D D D D D L L L L L L L G G G G G G G
